111111111111
110000000011
111C00C00011
11001Y000X11
111000001001
110C00110011
1111001C0001
111000100011
11P000110E11
111111111111
