111111111111
11111E10Y111
111010100C11
110C00000011
111000010111
11110C111111
1P00101C1C11
1001000000X1
110C00100011
111111111111
