111111111111
110000000C11
11001C00X111
1C0001000001
111Y11000011
11C001100111
11100C100C11
111001E00111
110P01111111
111111111111
